"filename", "language", "Markdown", "Python", "comment", "blank", "total"
"/Users/arjansingh/Wharton/PERFORMANCE_ANALYSIS_ALL_STOCKS_FIX.md", "Markdown", 174, 0, 0, 45, 219
"/Users/arjansingh/Wharton/PERFORMANCE_ANALYSIS_BUGFIXES.md", "Markdown", 219, 0, 0, 50, 269
"/Users/arjansingh/Wharton/PERFORMANCE_ANALYSIS_DEBUGGING.md", "Markdown", 234, 0, 0, 75, 309
"/Users/arjansingh/Wharton/PERFORMANCE_ANALYSIS_DEBUG_FIX.md", "Markdown", 151, 0, 0, 45, 196
"/Users/arjansingh/Wharton/PERFORMANCE_ANALYSIS_ENGINE.md", "Markdown", 286, 0, 0, 84, 370
"/Users/arjansingh/Wharton/PERFORMANCE_ANALYSIS_FINAL_FIX.md", "Markdown", 174, 0, 0, 59, 233
"/Users/arjansingh/Wharton/PERFORMANCE_ANALYSIS_IMPLEMENTATION.md", "Markdown", 241, 0, 0, 54, 295
"/Users/arjansingh/Wharton/PERFORMANCE_ANALYSIS_QUICKSTART.md", "Markdown", 142, 0, 0, 46, 188
"/Users/arjansingh/Wharton/PERFORMANCE_ANALYSIS_ROBUST_CALCULATION.md", "Markdown", 269, 0, 0, 80, 349
"/Users/arjansingh/Wharton/PERFORMANCE_ANALYSIS_WORKSHEET_FIX.md", "Markdown", 124, 0, 0, 34, 158
"/Users/arjansingh/Wharton/PERFORMANCE_ANALYSIS_WORKSHEET_SETUP.md", "Markdown", 135, 0, 0, 52, 187
"/Users/arjansingh/Wharton/app.py", "Python", 0, 462, 5, 3, 470
"/Users/arjansingh/Wharton/utils/performance_analysis_engine.py", "Python", 0, 938, 293, 140, 1371
"Total", "-", 2149, 1400, 298, 767, 4614